###############################
#p     b* *  1 * 2 *  * * *   #
# # # #*# # #*#*# # # #*#*#*# #
#  s*     ***  *  1   * 2 * * #
# # # # # #*# # #*#*# # # # #*#
#f         x **  *  *   1     #
# # # # # # # # # #*# #*# # # #
#*  *  1   *  *      *        #
# # # # #*# # # #*#*# # # # # #
#*    **  *       *           #
# #*# # # # # # #*# # # # # # #
#          1*   *  *          #
###############################