1 17 45
#############################################
#p x   b* *    *   *  * * *     ***   *     #
# # # #*# # #*#*# # # #*#*#*# # #*# #*# # # #
#  s*     ***  *  * 3 *   * *  *   ***      #
# # # # # #*# # #*#*# # # # #*# # #*#*# # # #
#f         x **  *  *    *    *    *        #
# # # # # # # # # #*# #*#*# # # # # # # # # #
#*  * *  3 *  *      ***       *  3 *   **  #
# # # # #*# # #*#*#*# # # # # # # # # # # # #
#*    **  *    *  *    *   4   *       * *  #
# # # # # # # # #*# # # # #*# # # # # # # # #
#  * *      *   *  * 4     ***   * 4   **   #
# # # # # # # # #*#*# # # # # # # # # # # # #
#  *   *** *    *    **        ***   4      #
# # # # #*# #*# #*# # # # # #*#*# # # # # # #
#        *               3                  #
#############################################
